case pXpYpZ:	avatarRotation = Ogre::Quaternion(+qw, +qx, +qy, +qz);	break
case nXpYpZ:	avatarRotation = Ogre::Quaternion(+qw, -qx, +qy, +qz);	break
case pXnYpZ:	avatarRotation = Ogre::Quaternion(+qw, +qx, -qy, +qz);	break
case nXnYpZ:	avatarRotation = Ogre::Quaternion(+qw, -qx, -qy, +qz);	break
case pXpYnZ:	avatarRotation = Ogre::Quaternion(+qw, +qx, +qy, -qz);	break
case nXpYnZ:	avatarRotation = Ogre::Quaternion(+qw, -qx, +qy, -qz);	break
case pXnYnZ:	avatarRotation = Ogre::Quaternion(+qw, +qx, -qy, -qz);	break
case nXnYnZ:	avatarRotation = Ogre::Quaternion(+qw, -qx, -qy, -qz);	break
case pXpZpY:	avatarRotation = Ogre::Quaternion(+qw, +qx, +qz, +qy);	break
case nXpZpY:	avatarRotation = Ogre::Quaternion(+qw, -qx, +qz, +qy);	break
case pXnZpY:	avatarRotation = Ogre::Quaternion(+qw, +qx, -qz, +qy);	break
case nXnZpY:	avatarRotation = Ogre::Quaternion(+qw, -qx, -qz, +qy);	break
case pXpZnY:	avatarRotation = Ogre::Quaternion(+qw, +qx, +qz, -qy);	break
case nXpZnY:	avatarRotation = Ogre::Quaternion(+qw, -qx, +qz, -qy);	break
case pXnZnY:	avatarRotation = Ogre::Quaternion(+qw, +qx, -qz, -qy);	break
case nXnZnY:	avatarRotation = Ogre::Quaternion(+qw, -qx, -qz, -qy);	break
case pYpXpZ:	avatarRotation = Ogre::Quaternion(+qw, +qy, +qx, +qz);	break
case nYpXpZ:	avatarRotation = Ogre::Quaternion(+qw, -qy, +qx, +qz);	break
case pYnXpZ:	avatarRotation = Ogre::Quaternion(+qw, +qy, -qx, +qz);	break
case nYnXpZ:	avatarRotation = Ogre::Quaternion(+qw, -qy, -qx, +qz);	break
case pYpXnZ:	avatarRotation = Ogre::Quaternion(+qw, +qy, +qx, -qz);	break
case nYpXnZ:	avatarRotation = Ogre::Quaternion(+qw, -qy, +qx, -qz);	break
case pYnXnZ:	avatarRotation = Ogre::Quaternion(+qw, +qy, -qx, -qz);	break
case nYnXnZ:	avatarRotation = Ogre::Quaternion(+qw, -qy, -qx, -qz);	break
case pYpZpX:	avatarRotation = Ogre::Quaternion(+qw, +qy, +qz, +qx);	break
case nYpZpX:	avatarRotation = Ogre::Quaternion(+qw, -qy, +qz, +qx);	break
case pYnZpX:	avatarRotation = Ogre::Quaternion(+qw, +qy, -qz, +qx);	break
case nYnZpX:	avatarRotation = Ogre::Quaternion(+qw, -qy, -qz, +qx);	break
case pYpZnX:	avatarRotation = Ogre::Quaternion(+qw, +qy, +qz, -qx);	break
case nYpZnX:	avatarRotation = Ogre::Quaternion(+qw, -qy, +qz, -qx);	break
case pYnZnX:	avatarRotation = Ogre::Quaternion(+qw, +qy, -qz, -qx);	break
case nYnZnX:	avatarRotation = Ogre::Quaternion(+qw, -qy, -qz, -qx);	break
case pZpXpY:	avatarRotation = Ogre::Quaternion(+qw, +qz, +qy, +qx);	break
case nZpXpY:	avatarRotation = Ogre::Quaternion(+qw, -qz, +qy, +qx);	break
case pZnXpY:	avatarRotation = Ogre::Quaternion(+qw, +qz, -qy, +qx);	break
case nZnXpY:	avatarRotation = Ogre::Quaternion(+qw, -qz, -qy, +qx);	break
case pZpXnY:	avatarRotation = Ogre::Quaternion(+qw, +qz, +qy, -qx);	break
case nZpXnY:	avatarRotation = Ogre::Quaternion(+qw, -qz, +qy, -qx);	break
case pZnXnY:	avatarRotation = Ogre::Quaternion(+qw, +qz, -qy, -qx);	break
case nZnXnY:	avatarRotation = Ogre::Quaternion(+qw, -qz, -qy, -qx);	break
case pZpYpX:	avatarRotation = Ogre::Quaternion(+qw, +qz, +qx, +qy);	break
case nZpYpX:	avatarRotation = Ogre::Quaternion(+qw, -qz, +qx, +qy);	break
case pZnYpX:	avatarRotation = Ogre::Quaternion(+qw, +qz, -qx, +qy);	break
case nZnYpX:	avatarRotation = Ogre::Quaternion(+qw, -qz, -qx, +qy);	break
case pZpYnX:	avatarRotation = Ogre::Quaternion(+qw, +qz, +qx, -qy);	break
case nZpYnX:	avatarRotation = Ogre::Quaternion(+qw, -qz, +qx, -qy);	break
case pZnYnX:	avatarRotation = Ogre::Quaternion(+qw, +qz, -qx, -qy);	break
case nZnYnX:	avatarRotation = Ogre::Quaternion(+qw, -qz, -qx, -qy);	break